1111111111111111111111111
10000000010000C0000000001
10000000010000000000000C1
10P0000001000000000011111
1000000001000000000010001
1000000000000000000011111
10000C0000000011110000001
111111111110001C011111111
1000000000000001000000001
1000010000000000000000001
10C0010000000000000C01111
10000111100010C0000100E01
1111111111111111111111111